MMMMMMMMMMMMMMMMMMMMMMWWWWWWWWWWWWWWWWWWWWWWWWWWWWWWWWWWWWWWWWWWWWWWWWWWWWWMMMMMMMMMMMMMMMMMMMMMMMMM
MooooooooooooooooooooooooooooooooooooooooooooooooooooooooooooooooooooooooooooooooooooooooooooooooooM
Mo                                                                                                oM
Mo                                                                                                oM
Mo                                                                                                oM
Mo                                                                                                oM
Mo                                                                                                oM
Mo                                                                                                oM
Mo                                                                                                oM
Mo                                                                                                oM
Mo                                                                                                oM
Moooooooooo       ooooooooooooooooooooooooooooooooooooooooooooooooooooooooooooo       oooooooooooooM
WWWWWWWWWWo       oWWWWWWWWWWWWWWWWWWWWWWWWWWWWWWWWWWWWWWWWWWWWWWWWWWWWWWWWWWWo       oWWWWWWWWWWWWW
WWWWWWWWWWo       oWWWWWWWWWWWWWWWWWWWWWWWWWWWWWWWWWWWWWWWWWWWWWWWWWWWWWWWWWWWo       oWWWWWWWWWWWWW
Moooooooooo       ooooooooooooooooooooooooooooooooooooooooooooooooooooooooooooo       oooooooooooooM
Mo                                                                                                oM
Mo                                              oooo                                              oM
Mo                                              oWWo                                              oM
Mo                                              oWWo                                              oM
Mo                                              oWWo                                              oM
Mo                                              oWWo                                              oM
Mo                                              oWWo                                              oM
Mo                                              oWWo                                              oM
Mo                                              oWWo                                              oM
Mo                            oooooooooooooooooooWWooooooooooooooooooo                            oM
Mo                            oWWWWWWWWWWWWWWWWWWWWWWWWWWWWWWWWWWWWWWo                            oM
Mo                            oWWWWWWWWWWWWWWWWWWWWWWWWWWWWWWWWWWWWWWo                            oM
Mo                            oooooooooooooooooooWWooooooooooooooooooo                            oM
Mo                                              oWWo                                              oM
Mo                                              oWWo                                              oM
Mo                                              oWWo                                              oM
Mo                                              oWWo                                              oM
Mo                                              oWWo                                              oM
Mo                                              oWWo                                              oM
Mo                                              oWWo                                              oM
Mo                                              oooo                                              oM
Mo                                                                                                oM
Mo                                                                                                oM
MooooooooooooooooooooooooooooooooooooooooooooooooooooooooooooooooooooooooooooooooooooooooooooooooooM
MMMMMMMMMMMMMMMMMMMMMMMMMWWWWWWWWWWWWWWWWWWWWWWWWWWWWWWWWWWWWWWWWWWWWWWWWWWWMMMMMMMMMMMMMMMMMMMMMMMM