MMMMMMMMMMMMMMMMMMMMMMMMMMMMMMMMMMMMMMMMMMMMMMMMMMMMMMMMMMMMMMMMMMMMMMMMMMMMMMMMMMMMMMMMMMMMMMMMMMMM
MooooooooooooooooooooooooooooooooooooooooooooooooooooooooooooooooooooooooooooooooooooooooooooooooooM
Mo                                                                                                oM
Mo                                                                                                oM
Mo                                                                                                oM
Mo                                                                                                oM
Mo                                                                                                oM
Mo                                                                                                oM
Mo                                                                                                oM
Mo                                                                                                oM
Mo                                                                                                oM
Mo                           oooooooooooooooooooooooooooooooooooooooooo                           oM
Mo                           oWWWWWWWWWWWWWWWWWWWWWWWWWWWWWWWWWWWWWWWWo                           oM
Mo                           oWWWWWWWWWWWWWWWWWWWWWWWWWWWWWWWWWWWWWWWWo                           oM
Mo                           oooooooooooooooooooooooooooooooooooooooooo                           oM
Mo                                                                                                oM
Mo                                                                                                oM
Mo                                                                                                oM
Mo                                                                                                oM
Mo                                                                                                oM
Mo                                                                                                oM
Mo                                                                                                oM
Mo                                                                                                oM
Mo                                                                                                oM
Mo                           oooooooooooooooooooooooooooooooooooooooooo                           oM
Mo                           oWWWWWWWWWWWWWWWWWWWWWWWWWWWWWWWWWWWWWWWWo                           oM
Mo                           oWWWWWWWWWWWWWWWWWWWWWWWWWWWWWWWWWWWWWWWWo                           oM
Mo                           oooooooooooooooooooooooooooooooooooooooooo                           oM
Mo                                                                                                oM
Mo                                                                                                oM
Mo                                                                                                oM
Mo                                                                                                oM
Mo                                                                                                oM
Mo                                                                                                oM
Mo                                                                                                oM
Mo                                                                                                oM
Mo                                                                                                oM
Mo                                                                                                oM
MooooooooooooooooooooooooooooooooooooooooooooooooooooooooooooooooooooooooooooooooooooooooooooooooooM
MMMMMMMMMMMMMMMMMMMMMMMMMMMMMMMMMMMMMMMMMMMMMMMMMMMMMMMMMMMMMMMMMMMMMMMMMMMMMMMMMMMMMMMMMMMMMMMMMMMM