MMMMMMMMMMMMMMMMMMMMMMMMMMMMMMMMMMMMMMMMMMMMMMMMMMMMMMMMMMMMMMMMMMMMMMMMMMMMMMMMMMMMMMMMMMMMMMMMMMMM
MooooooooooooooooooooooooooooooooooooooooooooooooooooooooooooooooooooooooooooooooooooooooooooooooooM
Mo                                                                                                oM
Mo                                                                                                oM
Mo                                                                                                oM
Mo                                                                                                oM
Mo                                                                                                oM
Mo                                                                                                oM
Mo                                                                                                oM
Mo                                                                                                oM
Mo                                                                                                oM
Mo                ooooooooooooooooooooooooooooooooooooooooooooooooooooooooooooooo                 oM
Mo                oWWWWWWWWWWWWWWWWWWWWWWWWWWWWWWWWWWWWWWWWWWWWWWWWWWWWWWWWWWWWWo                 oM
Mo                oWWWWWWWWWWWWWWWWWWWWWWWWWWWWWWWWWWWWWWWWWWWWWWWWWWWWWWWWWWWWWo                 oM
Mo                ooooooooooooooooooooooooooooooooooooooooooooooooooooooooooooooo                 oM
Mo                                                                                                oM
Mo                                                                                                oM
Mo                                                                                                oM
Mo                                                                                                oM
Mo                                                                                                oM
Mo                                                                                                oM
Mo                                                                                                oM
Mo                                                                                                oM
Mo                                                                                                oM
Mo                            oooooooooooooooooooooooooooooooooooooooo                            oM
Mo                            oWWWWWWWWWWWWWWWWWWWWWWWWWWWWWWWWWWWWWWo                            oM
Mo                            oWWWWWWWWWWWWWWWWWWWWWWWWWWWWWWWWWWWWWWo                            oM
Mo                            oooooooooooooooooooWWooooooooooooooooooo                            oM
Mo                                              oWWo                                              oM
Mo                                              oWWo                                              oM
Mo                                              oWWo                                              oM
Mo                                              oWWo                                              oM
Mo                                              oWWo                                              oM
Mo                                              oWWo                                              oM
Mo                                              oWWo                                              oM
Mo                                              oooo                                              oM
Mo                                                                                                oM
Mo                                                                                                oM
MooooooooooooooooooooooooooooooooooooooooooooooooooooooooooooooooooooooooooooooooooooooooooooooooooM
MMMMMMMMMMMMMMMMMMMMMMMMMMMMMMMMMMMMMMMMMMMMMMMMMMMMMMMMMMMMMMMMMMMMMMMMMMMMMMMMMMMMMMMMMMMMMMMMMMMM